----------------------------------|
-                                -|
-                                -|
----                     --     --|
-            --                  -|
-       !                         -|
-                                -|
-                    !           -|
--                   ----        -|
-                                -|
--                               -|
-                                -|
-                            --- -|
-                                -|
-                                -|
-      ---                       -|
-     !                          -|
-   --------        ----         -|
-                                -|
-                         -      -|
-                            --  -|
-                                -|
-                                -|
---------------              --  -|
-     !                          -|
-                                -|
----------------------------------|